 193 192 203 196 195 194 187 181 191 194 201 204 202 209 200 171
 207 208 209 209 213 212 210 210 210 212 207 210 208 213 209 182
 202 213 212 212 212 211 212 213 216 215 218 218 212 213 212 184
 207 212 210 211 214 215 216 214 210 212 212 213 210 210 211 182
 212 216 133 195 216 217 203 135 195 207 211 214 160 201 212 173
 209 216 141 164 214 213 178 116 169 212 213 199 126 209 214 172
 214 212 162 147 214 212 151 133 143 208 213 171 149 212 212 185
 211 216 190 127 204 210 119 171 126 198 209 147 168 210 210 179
 211 215 207 125 189 189 129 205 132 179 207 121 199 211 212 194
 208 214 213 156 165 162 155 209 165 158 180 124 209 212 211 203
 214 215 209 174 144 147 180 211 176 126 157 161 209 214 212 203
 213 215 213 194 117 129 192 211 206 115 125 181 209 211 214 206
 209 214 217 210 154 163 214 214 216 161 147 207 210 212 211 204
 203 215 214 214 211 212 212 213 214 211 212 211 212 214 212 191
 206 212 211 212 213 215 215 212 212 211 214 211 208 210 210 193
 195 196 196 200 198 204 202 208 208 204 207 207 202 204 203 195
 203 208 207 205 205 207 206 207 205 201 210 212 212 213 213 187
 208 213 211 214 213 214 215 216 216 217 218 217 217 214 216 187
 214 214 214 215 215 215 218 219 220 218 218 218 218 217 218 181
 214 215 205 214 217 218 219 219 220 218 219 218 218 217 217 185
 216 218 102 193 216 218 205 116 195 218 220 218 145 198 215 173
 217 220 124 166 217 218 179  99 158 216 219 201 107 210 215 171
 218 219 152 137 218 217 140 110 118 217 219 170 137 215 216 188
 219 216 187 108 214 216 106 172 102 206 216 131 155 215 216 178
 219 219 215 107 191 191 114 209 122 173 214 104 192 214 217 192
 221 220 216 141 160 159 151 211 159 143 190 108 214 214 216 210
 221 219 218 174 131 135 179 215 178 110 156 149 213 214 214 210
 221 220 220 205 104 105 200 218 210 103 109 177 215 213 214 209
 217 220 221 218 154 153 215 215 214 153 139 214 218 216 215 211
 218 221 221 218 215 215 218 216 216 212 213 216 217 216 216 196
 221 219 217 218 216 216 218 217 215 215 215 216 215 216 214 199
 196 195 197 199 204 206 206 209 210 212 211 212 206 199 198 195
 194 193 194 188 188 191 190 190 192 188 195 199 197 198 197 174
 192 198 198 197 198 198 198 201 202 199 198 196 196 199 200 169
 198 200 199 200 202 200 201 203 203 203 202 200 199 202 200 172
 204 204 190 200 201 200 200 203 202 202 203 204 201 200 202 170
 201 200  90 181 202 199 186 101 181 202 201 203 126 183 199 159
 201 199 111 153 204 199 163  85 141 202 200 181  91 200 201 155
 205 200 138 125 198 197 121  95 105 204 203 153 120 202 202 178
 203 204 169  95 195 194  86 156  82 187 202 116 136 201 203 167
 201 204 200  93 177 172 100 196 107 160 195  92 180 203 204 183
 202 205 203 127 147 143 133 198 147 124 174  94 196 202 200 195
 201 203 204 158 117 119 161 198 161  92 139 130 203 203 198 196
 201 201 200 188  91  88 182 197 194  83  89 161 203 202 200 201
 202 203 200 200 139 137 203 200 202 143 120 201 201 203 201 199
 201 204 203 203 200 202 203 204 201 201 202 200 201 200 199 187
 201 204 203 203 207 203 201 204 202 200 202 200 201 201 199 187
 183 184 184 190 191 193 188 197 203 201 199 199 194 187 182 178

 171 182 184 182 173 172 185 179 194 203 203 206 204 191 193 195
 200 209 212 211 212 214 212 210 212 211 212 214 211 212 210 203
 209 213 213 210 201 209 212 210 211 212 214 211 212 214 210 204
 202 208 212 210 160 126 149 168 199 209 209 209 210 212 208 202
 204 210 218 213 214 199 171 147 121 124 161 181 207 211 211 207
 201 207 218 212 211 213 213 209 207 180 157 125 147 212 214 207
 194 212 215 212 207 212 208 198 179 158 126 115 161 211 211 204
 191 210 216 210 195 169 143 126 132 165 176 206 216 214 212 208
 181 210 213 214 135 116 133 171 205 209 211 211 214 213 212 208
 187 210 212 216 203 178 151 119 129 155 180 192 214 212 215 202
 194 212 211 215 217 213 212 210 189 162 147 129 163 212 215 204
 195 213 212 214 216 214 214 204 189 165 144 117 154 211 213 198
 196 209 212 211 195 164 147 127 125 156 174 194 210 214 212 200
 203 209 212 210 133 141 162 190 207 213 209 213 217 214 211 196
 192 208 213 212 216 216 212 216 215 214 215 215 214 215 212 196
 193 207 202 207 212 209 214 211 211 208 214 213 209 203 206 195
 187 187 181 185 173 171 188 178 192 210 210 209 211 196 199 195
 213 216 218 217 215 215 216 216 217 216 214 214 215 216 214 198
 213 214 217 217 198 210 215 215 214 214 214 213 216 216 216 199
 212 217 218 218 145 107 137 155 192 214 213 215 218 217 215 206
 212 217 218 218 218 201 170 131 104 108 149 177 214 216 216 212
 210 218 218 219 220 219 219 216 214 190 156 109 139 213 215 211
 201 217 218 218 218 216 217 206 173 143 110 103 153 212 215 212
 205 216 220 220 195 158 118 102 122 159 178 210 214 216 215 210
 207 216 219 219 116  99 110 172 209 211 215 218 215 216 217 209
 206 215 218 219 205 179 140 106 114 151 179 200 215 218 218 206
 207 214 215 218 218 218 217 216 191 159 135 105 153 215 216 206
 205 213 215 217 216 217 218 214 191 160 131 104 154 215 216 204
 205 214 215 214 193 166 137 108 107 141 174 205 218 218 218 199
 207 211 214 205 102 124 152 187 215 216 218 220 221 221 217 197
 208 213 214 215 218 220 219 216 219 220 219 220 220 221 219 195
 203 208 214 214 216 217 218 219 219 221 221 221 217 218 221 196
 174 169 172 170 159 155 178 167 183 195 196 201 199 187 187 178
 197 200 200 202 199 201 202 203 204 200 198 200 201 199 199 182
 198 199 202 200 183 200 202 201 203 202 203 202 203 200 201 187
 197 196 199 201 126  91 120 136 180 196 203 203 201 201 201 194
 199 196 200 204 203 181 153 116  92  94 130 161 201 200 200 199
 195 198 202 203 201 200 203 202 195 174 139  89 120 202 202 199
 188 199 203 202 202 202 204 187 160 124  92  83 143 201 200 201
 192 202 203 202 181 141 105  82 107 147 161 194 202 201 202 203
 190 201 203 203 101  85  95 156 196 198 198 197 200 204 204 197
 190 198 201 200 186 163 121  86 100 133 161 182 203 203 201 188
 191 198 200 200 199 199 197 194 172 143 119  88 137 202 203 193
 188 198 202 201 202 204 198 195 177 147 117  91 139 200 207 191
 188 197 200 200 181 153 125  95  93 127 158 188 200 203 203 190
 194 198 199 190  90 111 138 169 200 203 204 200 200 203 203 184
 193 198 200 204 200 199 200 204 204 205 203 201 203 204 204 184
 194 192 198 204 201 201 205 203 201 202 201 201 202 201 201 183

 195 203 204 202 207 207 204 208 208 202 204 198 200 196 196 195
 193 210 210 208 211 214 211 212 212 215 215 213 212 211 212 206
 191 212 214 212 211 212 211 214 213 212 212 211 214 214 215 203
 204 211 212 210 207 147 161 216 214 214 163 154 210 217 214 209
 206 214 211 209 181 125 115 206 211 192 129 117 194 213 215 213
 203 212 214 209 161 157 126 176 211 180 147 144 174 209 215 214
 203 211 212 209 124 180 158 165 209 155 162 165 156 213 214 208
 194 212 211 199 121 207 179 132 205 129 189 189 125 207 215 211
 179 210 210 168 147 209 198 126 171 119 210 204 127 190 216 211
 185 212 212 149 171 213 208 143 133 151 212 214 147 162 212 214
 172 214 209 126 199 213 212 169 116 178 213 214 164 141 216 209
 173 212 201 160 214 211 207 195 135 203 217 216 195 133 216 212
 182 211 210 210 213 212 212 210 214 216 215 214 211 210 212 207
 184 212 213 212 218 218 215 216 213 212 211 212 212 212 213 202
 182 209 213 208 210 207 212 210 210 210 212 213 209 209 208 207
 171 200 209 202 204 201 194 191 181 187 194 195 196 203 192 193
 195 198 199 206 212 211 212 210 209 206 206 204 199 197 195 196
 199 214 216 215 216 215 215 215 217 218 216 216 218 217 219 221
 196 216 216 217 216 213 212 216 216 218 215 215 218 221 221 218
 211 215 216 218 214 139 153 214 215 215 153 154 218 221 220 217
 209 214 213 215 177 109 103 210 218 200 105 104 205 220 220 221
 210 214 214 213 149 156 110 178 215 179 135 131 174 218 219 221
 210 216 214 214 108 190 143 159 211 151 159 160 141 216 220 221
 192 217 214 192 104 214 173 122 209 114 191 191 107 215 219 219
 178 216 215 155 131 216 206 102 172 106 216 214 108 187 216 219
 188 216 215 137 170 219 217 118 110 140 217 218 137 152 219 218
 171 215 210 107 201 219 216 158  99 179 218 217 166 124 220 217
 173 215 198 145 218 220 218 195 116 205 218 216 193 102 218 216
 185 217 217 218 218 219 218 220 219 219 218 217 214 205 215 214
 181 218 217 218 218 218 218 220 219 218 215 215 215 214 214 214
 187 216 214 217 217 218 217 216 216 215 214 213 214 211 213 208
 187 213 213 212 212 210 201 205 207 206 207 205 205 207 208 203
 178 182 187 194 199 199 201 203 197 188 193 191 190 184 184 183
 187 199 201 201 200 202 200 202 204 201 203 207 203 203 204 201
 187 199 200 201 200 202 201 201 204 203 202 200 203 203 204 201
 199 201 203 201 201 120 143 202 200 203 137 139 200 200 203 202
 201 200 202 203 161  89  83 194 197 182  88  91 188 200 201 201
 196 198 203 203 130 139  92 161 198 161 119 117 158 204 203 201
 195 200 202 196  94 174 124 147 198 133 143 147 127 203 205 202
 183 204 203 180  92 195 160 107 196 100 172 177  93 200 204 201
 167 203 201 136 116 202 187  82 156  86 194 195  95 169 204 203
 178 202 202 120 153 203 204 105  95 121 197 198 125 138 200 205
 155 201 200  91 181 200 202 141  85 163 199 204 153 111 199 201
 159 199 183 126 203 201 202 181 101 186 199 202 181  90 200 201
 170 202 200 201 204 203 202 202 203 200 200 201 200 190 204 204
 172 200 202 199 200 202 203 203 203 201 200 202 200 199 200 198
 169 200 199 196 196 198 199 202 201 198 198 198 197 198 198 192
 174 197 198 197 199 195 188 192 190 190 191 188 188 194 193 194

 195 206 203 209 213 214 208 211 211 214 209 212 207 202 207 193
 196 212 215 214 215 215 214 215 216 212 216 216 212 213 208 192
 196 211 214 217 213 209 213 207 190 162 141 133 210 212 209 203
 200 212 214 210 194 174 156 125 127 147 164 195 211 212 209 196
 198 213 211 154 117 144 165 189 204 214 214 216 214 212 213 195
 204 215 212 163 129 147 162 189 210 212 213 217 215 211 212 194
 202 215 212 214 192 180 155 129 119 151 178 203 216 212 210 187
 208 212 213 214 211 211 209 205 171 133 116 135 214 213 210 181
 208 212 214 216 206 176 165 132 126 143 169 195 210 216 210 191
 204 211 211 161 115 126 158 179 198 208 212 207 212 215 212 194
 207 214 212 147 125 157 180 207 209 213 213 211 212 218 207 201
 207 211 211 207 181 161 124 121 147 171 199 214 213 218 210 204
 202 208 212 210 209 209 209 199 168 149 126 160 210 212 208 202
 204 210 214 212 211 214 212 211 210 212 209 201 210 213 213 209
 203 210 212 211 214 212 211 212 210 212 214 212 211 212 209 200
 195 193 191 204 206 203 203 194 179 185 172 173 182 184 182 171
 196 221 218 217 221 221 221 219 219 218 217 216 214 214 208 203
 195 219 221 220 220 219 220 219 216 219 220 218 215 214 213 208
 197 217 221 221 220 218 216 215 187 152 124 102 205 214 211 207
 199 218 218 218 205 174 141 107 108 137 166 193 214 215 214 205
 204 216 215 154 104 131 160 191 214 218 217 216 217 215 213 205
 206 216 215 153 105 135 159 191 216 217 218 218 218 215 214 207
 206 218 218 215 200 179 151 114 106 140 179 205 219 218 215 206
 209 217 216 215 218 215 211 209 172 110  99 116 219 219 216 207
 210 215 216 214 210 178 159 122 102 118 158 195 220 220 216 205
 212 215 212 153 103 110 143 173 206 217 216 218 218 218 217 201
 211 215 213 139 109 156 190 214 216 219 219 220 219 218 218 210
 212 216 216 214 177 149 108 104 131 170 201 218 218 218 217 212
 206 215 217 218 215 213 214 192 155 137 107 145 218 218 217 212
 199 216 216 216 213 214 214 214 215 215 210 198 217 217 214 213
 198 214 216 215 214 214 216 217 216 216 215 215 217 218 216 213
 195 199 196 211 209 210 210 192 178 188 171 173 185 181 187 187
 183 201 201 202 201 201 202 201 203 205 201 201 204 198 192 194
 184 204 204 203 201 203 205 204 204 200 199 200 204 200 198 193
 184 203 203 200 200 204 203 200 169 138 111  90 190 199 198 194
 190 203 203 200 188 158 127  93  95 125 153 181 200 200 197 188
 191 207 200 139  91 117 147 177 195 198 204 202 201 202 198 188
 193 203 202 137  88 119 143 172 194 197 199 199 200 200 198 191
 188 201 203 203 182 161 133 100  86 121 163 186 200 201 198 190
 197 204 204 200 197 198 198 196 156  95  85 101 203 203 201 190
 203 202 201 202 194 161 147 107  82 105 141 181 202 203 202 192
 201 200 201 143  83  92 124 160 187 204 202 202 202 203 199 188
 199 202 202 120  89 139 174 195 202 203 200 201 203 202 198 195
 199 200 200 201 161 130  94  92 116 153 181 203 204 200 196 199
 194 201 201 201 203 203 196 180 136 120  91 126 201 199 196 197
 187 201 200 203 202 203 202 203 201 202 200 183 200 202 199 198
 182 199 199 201 200 198 200 204 203 202 201 199 202 200 200 197
 178 187 187 199 201 196 195 183 167 178 155 159 170 172 169 174

