 160 165 160 150 162 167 156 143 152 151 147 147 162 163 161 149
 169 174 174 168 165 169 176 179 174 173 176 178 174 173 176 157
 169 169 172 170 168 169 171 171 177 174 169 170 176 175 174 161
 163 165 174 172 174 168 171 173 174 175 173 173 174 173 174 162
 164 158 132 165 167 166 164 126 173 169 169 172 121 161 174 163
 165 158 103 155 167 170 149  96 139 174 178 170 101 161 173 163
 165 166 116 135 171 171 123 100 116 172 174 146 114 174 174 163
 168 172 142 115 175 166 106 136 101 169 172 126 136 175 174 161
 171 174 159 104 168 155 105 162 103 150 169 107 153 173 168 160
 172 168 164 107 147 140 120 175 121 122 158  99 157 167 169 163
 165 170 171 136 125 131 140 165 140  93 131 108 168 170 169 158
 166 170 170 155 111 108 154 165 166  98 113 136 170 170 168 157
 168 167 170 166 108  97 169 176 180 110  92 161 173 172 171 166
 171 169 172 173 155 146 169 169 171 160 146 165 167 168 174 168
 169 171 173 173 172 170 174 177 170 166 170 173 173 171 170 163
 170 169 168 169 171 172 176 172 168 171 171 175 172 172 172 165
 164 170 166 164 178 178 174 165 175 172 169 172 178 176 171 157
 175 178 176 177 179 178 178 177 178 180 178 179 178 177 180 165
 175 175 177 176 179 178 179 174 178 180 179 180 181 176 177 166
 175 175 181 178 182 179 182 178 179 179 178 180 180 176 178 166
 177 169 142 178 179 177 171 124 173 181 179 178 126 167 180 166
 174 168 113 166 180 181 157 101 144 180 180 172 104 169 180 169
 174 175 124 143 179 180 133 106 119 179 181 154 117 178 181 171
 173 179 148 116 178 174 114 137  97 173 180 132 138 180 179 168
 171 177 164 105 171 160 110 167 107 152 175 110 149 177 179 169
 172 171 170 111 150 147 120 174 125 124 161 102 161 175 176 167
 169 171 169 133 122 130 141 174 145 100 138 112 171 174 173 165
 171 173 168 155 108 105 160 172 167  92 107 134 172 173 173 166
 174 174 176 169 105  93 172 174 177 112  90 159 174 175 175 171
 176 174 174 177 162 154 176 175 178 167 155 175 176 174 175 170
 174 176 176 176 177 179 176 176 177 177 179 178 178 178 178 171
 176 176 177 179 177 175 176 176 178 181 180 180 180 180 179 173
 168 169 166 162 171 174 174 173 175 170 168 173 181 183 180 162
 173 175 175 175 177 176 173 177 176 175 173 171 171 172 174 162
 175 174 176 174 176 177 177 173 175 174 173 172 172 170 172 162
 172 169 174 170 173 171 175 175 171 173 173 174 173 171 173 159
 172 161 133 168 172 171 166 115 166 175 175 171 118 158 171 157
 170 162 108 161 173 173 150  98 143 172 172 165 100 163 170 158
 170 167 120 140 172 172 126 104 116 175 175 148 115 174 170 161
 171 171 141 113 174 166 107 136 103 172 177 131 135 173 168 160
 165 169 158 102 166 154 106 163 102 148 172 109 147 169 167 160
 165 165 166 109 150 142 116 168 115 117 157 100 160 169 168 160
 165 169 170 135 126 129 138 165 142 101 135 105 167 169 169 163
 165 167 165 154 112 109 159 167 162  90 109 137 171 169 169 163
 166 165 170 169 109  95 168 170 173 114  97 161 171 170 167 163
 170 166 170 172 156 148 169 168 170 159 150 172 175 173 172 164
 170 170 169 169 169 171 171 173 172 171 177 178 176 175 171 163
 174 170 167 168 169 175 176 172 172 174 175 176 174 173 169 165

 149 157 161 162 163 163 163 161 160 163 158 157 166 168 163 165
 161 176 174 174 174 173 174 174 168 169 169 168 171 174 170 172
 163 173 175 173 161 161 174 175 173 167 170 170 172 168 171 172
 162 174 176 174 121 101 114 136 153 157 168 170 173 167 173 172
 147 178 170 173 172 170 146 126 107  99 108 136 161 165 173 175
 147 176 169 173 169 178 174 172 169 158 131 113  92 146 170 171
 151 173 174 175 169 174 172 169 150 122  93  98 110 160 166 171
 152 174 177 174 173 139 116 101 103 121 140 166 180 171 170 168
 143 179 171 173 126  96 100 136 162 175 165 165 176 169 177 172
 156 176 171 171 164 149 123 106 105 120 140 154 169 169 174 176
 167 169 169 168 166 170 171 166 155 140 131 108  97 146 170 172
 162 165 168 174 167 167 171 175 168 147 125 111 108 155 172 171
 150 168 170 172 165 155 135 115 104 107 136 155 166 173 173 169
 160 174 172 174 132 103 116 142 159 164 171 170 170 172 173 168
 165 174 169 165 158 158 166 172 174 168 170 170 167 169 171 169
 160 169 169 163 164 165 165 168 171 172 165 166 168 171 169 170
 157 165 166 166 166 169 171 168 169 167 165 166 171 170 171 173
 171 180 177 178 180 180 181 179 179 176 173 173 175 175 178 179
 176 177 176 176 167 169 178 180 177 175 174 173 175 174 178 180
 178 178 181 180 126 104 117 138 149 161 171 172 174 176 178 180
 172 179 180 180 178 172 154 132 110 102 112 134 159 175 178 180
 169 178 179 178 179 180 181 180 175 161 138 107  90 155 179 180
 172 180 180 179 181 180 179 173 152 124 100  92 112 167 177 181
 175 178 178 179 173 144 119  97 107 125 145 167 177 178 177 178
 165 177 174 178 124 101 106 137 167 174 174 172 174 175 176 176
 174 178 179 182 171 157 133 114 110 120 141 160 172 176 176 176
 178 178 178 179 177 181 180 174 160 147 130 105  93 154 179 175
 178 179 179 182 179 180 179 178 171 150 122 108 105 162 177 177
 164 177 176 178 178 166 143 116 105 111 133 155 169 177 176 179
 166 176 177 181 142 113 124 148 164 170 169 168 176 174 176 177
 170 178 175 175 169 168 175 179 177 171 171 173 174 174 176 176
 164 175 175 175 177 174 174 173 171 172 169 171 174 176 174 176
 162 162 162 159 157 158 161 160 160 160 163 163 163 164 163 165
 180 174 172 173 171 170 170 168 167 168 169 169 167 172 171 169
 183 172 170 171 158 163 174 173 169 169 169 169 170 173 175 173
 181 171 172 173 118 100 115 135 147 160 167 171 171 175 176 174
 173 171 172 174 171 165 148 131 109 100 105 137 161 172 178 176
 168 173 173 173 175 172 175 177 172 157 135 109  97 150 177 175
 170 175 174 173 175 172 175 172 148 117 101  90 114 159 171 174
 175 176 175 171 166 143 116 103 102 115 142 162 173 170 172 172
 173 177 173 175 115  98 104 136 163 168 165 167 170 168 173 172
 174 173 177 175 166 150 126 107 106 116 138 159 168 169 171 176
 174 176 177 171 171 173 172 166 154 142 129 109  95 148 171 175
 171 177 176 173 172 173 172 174 166 150 126 112 109 156 169 169
 162 175 174 170 168 161 140 113 102 109 135 154 169 172 169 168
 166 175 176 174 133 108 120 141 158 166 170 165 170 170 169 167
 169 175 174 169 161 162 167 171 169 165 169 167 165 166 170 170
 168 173 175 172 172 170 170 171 165 165 165 165 166 170 170 174

 165 172 172 172 175 171 171 168 172 176 172 171 169 168 169 170
 163 170 171 173 173 170 166 170 177 174 170 172 173 173 171 169
 168 174 168 167 165 146 160 171 169 169 146 155 173 172 169 171
 166 171 172 173 161  92 110 180 176 169  97 108 166 170 167 168
 157 168 170 170 136 113  98 166 165 154 108 111 155 170 170 166
 158 169 170 168 108 131  93 140 165 140 131 125 136 171 170 165
 163 169 167 157  99 158 122 121 175 120 140 147 107 164 168 172
 160 168 173 153 107 169 150 103 162 105 155 168 104 159 174 171
 161 174 175 136 126 172 169 101 136 106 166 175 115 142 172 168
 163 174 174 114 146 174 172 116 100 123 171 171 135 116 166 165
 163 173 161 101 170 178 174 139  96 149 170 167 155 103 158 165
 163 174 161 121 172 169 169 173 126 164 166 167 165 132 158 164
 162 174 173 174 173 173 175 174 173 171 168 174 172 174 165 163
 161 174 175 176 170 169 174 177 171 171 169 168 170 172 169 169
 157 176 173 174 178 176 173 174 179 176 169 165 168 174 174 169
 149 161 163 162 147 147 151 152 143 156 167 162 150 160 165 160
 173 179 180 180 180 180 181 178 176 176 175 177 179 177 176 176
 171 178 178 178 178 179 177 177 176 176 179 177 176 176 176 174
 170 175 174 176 175 155 167 178 175 176 154 162 177 174 174 176
 171 175 175 174 159  90 112 177 174 172  93 105 169 176 174 174
 166 173 173 172 134 107  92 167 172 160 105 108 155 168 173 171
 165 173 174 171 112 138 100 145 174 141 130 122 133 169 171 169
 167 176 175 161 102 161 124 125 174 120 147 150 111 170 171 172
 169 179 177 149 110 175 152 107 167 110 160 171 105 164 177 171
 168 179 180 138 132 180 173  97 137 114 174 178 116 148 179 173
 171 181 178 117 154 181 179 119 106 133 180 179 143 124 175 174
 169 180 169 104 172 180 180 144 101 157 181 180 166 113 168 174
 166 180 167 126 178 179 181 173 124 171 177 179 178 142 169 177
 166 178 176 180 180 178 179 179 178 182 179 182 178 181 175 175
 166 177 176 181 180 179 180 178 174 179 178 179 176 177 175 175
 165 180 177 178 179 178 180 178 177 178 178 179 177 176 178 175
 157 171 176 178 172 169 172 175 165 174 178 178 164 166 170 164
 165 169 173 174 176 175 174 172 172 176 175 169 168 167 170 174
 163 171 175 176 178 177 171 172 173 171 171 169 169 169 170 170
 164 172 173 175 172 150 159 170 168 169 148 156 172 170 166 170
 163 167 170 171 161  97 114 173 170 168  95 109 169 170 165 166
 163 169 169 171 137 109  90 162 167 159 109 112 154 165 167 165
 163 169 169 167 105 135 101 142 165 138 129 126 135 170 169 165
 160 168 169 160 100 157 117 115 168 116 142 150 109 166 165 165
 160 167 169 147 109 172 148 102 163 106 154 166 102 158 169 165
 160 168 173 135 131 177 172 103 136 107 166 174 113 141 171 171
 161 170 174 115 148 175 175 116 104 126 172 172 140 120 167 170
 158 170 163 100 165 172 172 143  98 150 173 173 161 108 162 170
 157 171 158 118 171 175 175 166 115 166 171 172 168 133 161 172
 159 173 171 173 174 173 173 171 175 175 171 173 170 174 169 172
 162 172 170 172 172 173 174 175 173 177 177 176 174 176 174 175
 162 174 172 171 171 173 175 176 177 173 176 177 175 175 175 173
 162 180 183 181 173 168 170 175 173 174 174 171 162 166 169 168

 170 169 171 168 166 165 172 171 168 165 165 164 163 169 169 160
 169 171 169 167 170 170 168 174 172 166 158 158 165 169 174 165
 168 173 172 170 170 171 164 159 142 116 103 132 174 172 174 160
 169 173 173 166 155 136 107 104 115 135 155 165 172 170 168 150
 171 172 155 108 111 125 147 168 175 171 167 167 174 168 165 162
 172 170 146  97 108 131 140 155 166 171 170 166 168 169 169 167
 176 174 169 169 154 140 120 105 106 123 149 164 171 171 176 156
 172 177 169 176 165 165 175 162 136 100  96 126 173 171 179 143
 168 170 171 180 166 140 121 103 101 116 139 173 174 177 174 152
 171 166 160 110  98  93 122 150 169 172 174 169 175 174 173 151
 171 170 146  92 113 131 158 169 172 174 178 169 173 169 176 147
 175 173 165 161 136 108  99 107 126 146 170 172 173 170 178 147
 172 173 167 173 170 168 157 153 136 114 101 121 174 176 174 162
 172 171 168 172 170 170 167 173 175 174 161 161 173 175 173 163
 172 170 174 171 168 169 169 168 174 174 173 174 174 174 176 161
 165 163 168 166 157 158 163 160 161 163 163 163 162 161 157 149
 176 174 176 174 171 169 172 171 173 174 174 177 175 175 175 164
 176 176 174 174 173 171 171 177 179 175 168 169 175 175 178 170
 177 176 174 176 168 169 170 164 148 124 113 142 181 177 176 166
 179 176 177 169 155 133 111 105 116 143 166 178 178 176 177 164
 177 177 162 105 108 122 150 171 178 179 180 179 182 179 179 178
 175 179 154  93 105 130 147 160 174 180 181 177 179 178 178 178
 176 176 176 172 160 141 120 110 114 133 157 171 182 179 178 174
 176 176 175 174 172 174 174 167 137 106 101 124 178 174 177 165
 178 177 178 177 167 145 125 107  97 119 144 173 179 178 178 175
 181 177 167 112  92 100 124 152 173 179 180 181 179 180 180 172
 180 179 155  90 107 138 161 175 180 181 180 179 178 179 178 169
 180 178 175 159 134 112 102 110 132 154 172 178 180 180 179 172
 180 178 176 174 172 171 161 149 138 117 104 126 180 181 178 178
 180 178 174 175 173 174 175 177 180 178 169 167 176 176 177 176
 179 178 175 175 173 173 176 179 179 181 180 180 178 177 180 171
 173 171 170 171 166 165 167 169 168 171 169 166 166 166 165 157
 174 170 170 166 165 165 165 165 171 170 170 172 172 175 173 168
 170 170 166 165 167 169 165 169 171 167 162 161 169 174 175 169
 167 169 170 170 165 170 166 158 141 120 108 133 174 176 175 166
 168 169 172 169 154 135 109 102 113 140 161 168 170 174 175 162
 169 169 156 109 112 126 150 166 174 172 173 172 173 176 177 171
 175 171 148  95 109 129 142 154 166 172 173 171 171 177 176 174
 176 171 169 168 159 138 116 106 107 126 150 166 175 177 173 174
 172 173 168 170 167 165 168 163 136 104  98 115 175 173 177 173
 172 172 170 173 162 142 115 102 103 116 143 166 171 175 176 175
 174 171 159 114  90 101 117 148 172 175 172 175 173 174 175 170
 175 177 150  97 109 135 157 172 177 175 172 175 173 173 173 168
 176 178 172 161 137 105 100 109 131 148 165 171 174 172 171 173
 174 176 175 171 171 167 160 147 135 115 100 118 173 172 171 181
 173 175 173 170 169 169 169 169 173 174 163 158 171 170 172 183
 169 171 172 167 169 169 168 167 168 170 170 171 173 172 174 180
 165 163 164 163 163 163 160 160 160 161 158 157 159 162 162 162

